111111111111
10000000CPE1
111111111011
