1111111111111111111111
1E00000000000C00000001
110000011110000C000001
10000011C1100000000001
1000000000100000000001
1P00000100100C00000001
1111111111111111111111
