1111111111111111111111
1100000000000C00000001
100000011110000C000001
10000011C1100000000001
1000001000100000CE0001
100000P000000000000001
1111111111111111111111
