1111111111
100C0M0001
100000C011
11P1111E11
1111111111
