1111111111111111111111111111111111111111111111
1000000000000000000000000000000000000000000001
1000P00000000000000011111111111111111111111111
1000000000000111111111111110000000001111000011
100C000000000000000111000001000000000C00111111
10000000000000000C0000000000000C00000000000001
1111111000111110000001111110000000000000001111
11111111111111100001111111111110000000000E1111
1111111111111111111111111111111111111111111111
