11111111111111111111
10001011111000001111
10010000C00000011111 
10010000P0000E011111
10001111101100000C11
11111111111111111111
