11111111
10P00001
11100E01
1C100001
11111111
