1111111
1PP0011
100EC11
1111111
