11111111
10P00001
11100001
1C100001
11111111
