  1111
100CPE1
1000001
1111111
